RG=REGISTRO GERAL
CH=CARTEIRA NACIONAL HABILITAÇÃO
RN=IDENTIDADE DE ESTRANGEIRO
PL=CART.IDENT.EXP.CONSELHO PROF.LIBERAIS
PF=CART.IDENT.EXPEDIDA POLICIA FEDERAL
MT=CARTEIRA DE TRABALHO PREVIDÊNCIA SOCIAL
AR=CARTEIRA IDENT.EXPEDIDA FORÇAS ARMADAS
JZ=CARTEIRA IDENTIDADE DE JUÍZES
RP=CONSELHO REG DE PROF DE RELACOES PUBLICA
RC=CONSELHO REG DE REPRESENTANTE COMERCIAIS
AM=CONSELHO REG. TECNICOS DE ADMINISTRACAO
AS=CONSELHO REG. DE ASSISTENTES SOCIAIS
BT=CONSELHO REG. DE BIBLIOTECONOMIA
CT=CONSELHO REG. DE CONTABILIDADE
CI=CONSELHO REG. DE CORRETORES DE IMOVEIS
EC=CONSELHO REG. DE ECONOMIA
EF=CONSELHO REG. DE ENFERMAGEM
FA=CONSELHO REG. DE FARMACIA
MD=CONSELHO REG. DE MEDICINA
MV=CONSELHO REG. DE MEDICINA VETERINARIA
NT=CONSELHO REG. DE NUTRICIONISTA
OD=CONSELHO REG. DE ODONTOLOGIA
PS=CONSELHO REG. DE PSICOLOGIA
KS=CONSELHO REG. DE QUIMICA
EN=CONSELHO REG. ENGENHARIA E ARQUITETURA
AE=MINISTERIO DA AERONAUTICA
MJ=MINISTERIO DA JUSTICA
MR=MINISTERIO DA MARINHA
ME=MINISTERIO DAS RELACOES EXTERIORES
EX=MINISTERIO DO EXERCITO
AD=ORDEM DOS ADVOGADOS DO BRASIL
PP=PASSAPORTE
TO=TERAPEUTA OCUPACIONAL
TE=TÍTULO DE ELEITOR